SBVT


SBAX	Araxá	MG
SBPR	Carlos Prates	MG
SBBQ	Barbacena	MG
SBBH	Pampulha	MG
SBCF	Tancredo Neves	MG
SBPC	Poços de Caldas	MG
SBUR	Uberaba	MG
SBUL	Uberlândia	MG
SBIP	Ipatinga	MG
SBJF	Francisco de Assis	MG
SBMK	Montes Claros	MG
SBVG	Varginha	MG
SBGV	Gov. Valadares	MG


SBCB	Cabo Frio	RJ
SBAF	Afonsos	RJ
SBGL	Galeão	RJ
SBJR	Jacarepaguá	RJ
SBRJ	Santos Dumont	RJ
SBSC	Santa Cruz	RJ
SBME	Macaé	RJ
SBES	S. Pedro da Aldeia	RJ
SBCP	Bartolomeu Lysandro	RJ


SBAU	Araçatuba	SP
SBBU	Bauru	SP
SBKP	Viracopos	SP
SBDN	Pres. Prudente	SP
SBRP	Leite Lopes	SP
SBSR	S. J. do Rio Preto	SP
SBYS	Fontenelle	SP
SBST	Base Aérea	SP
SBGP	Gavião Peixoto	SP
SBGW	Guaratinguetá	SP
SBGR	Guarulhos	SP
SBSJ	São J. dos Campos	SP
SBMT	Campo de Marte	SP
SBSP	Congonhas	SP
SBTA	Taubaté	SP